Text Foosball
An Interactive Fiction
Release 1 / Serial number 140831 / Inform 7 build 6L02 (I6/v6.33 lib 6/12N) SD

Lounge
The Lounge is appointed with everything necessary to rest and relaxation: a vending machine, a potted palm, a stack of Entertainment Weekly issues from 1993, and -- your pride and joy -- a foosball game.

On the foosball game is a small white ball (still).

Joey is hunkered over the foosball handles on his side of the table.

>l
Stuffy Office
The windows are closed, making the sultry air even more unbearable. A narrow slice of Caribbean blue is visible between the scuba gear rental shop and the recreated 17th century pirate tavern.

The office is cheerfully furnished with wicker chairs and white curtains, but the tropical decorating scheme stopped at the desk, which is heavy oak and absolutely covered with papers.

>n
You can't go that way.

>ask the captain
What do you want to ask the Captain for?

>ask the captain where is the coke?
I didn't understand that sentence.

>ask the captain "Where is the coke?"
I didn't understand that sentence.

>x captain
The Captain is wearing a baseball cap and carrying a small silver key.

>ask captain for key
"Sure, you can -- well, get me a drink first, would you?"

>l
Cabin
The front of the small cabin is entirely occupied with navigational instruments, a radar display, and radios for calling back to shore. Along each side runs a bench with faded blue vinyl cushions, which can be lifted to reveal the storage space underneath. A glass case against the wall contains several fishing rods.

Scratched windows offer a view of the surrounding bay, and there is a door south to the deck. A sign taped to one wall announces the menu of tours offered by the Yakutat Charter Boat Company.

The captain sits at the wheel, steering the boat and occasionally checking the radar readout.

>take cushion
You can't see any such thing.

>take cushions
They're hardly portable.

>lift cushions
That's not a verb I recognise.

>x cushions
You see nothing special about the blue vinyl cushions.

>where is the drink?
That's not a verb I recognise.

>l
Cabin
The front of the small cabin is entirely occupied with navigational instruments, a radar display, and radios for calling back to shore. Along each side runs a bench with faded blue vinyl cushions, which can be lifted to reveal the storage space underneath. A glass case against the wall contains several fishing rods.

Scratched windows offer a view of the surrounding bay, and there is a door south to the deck. A sign taped to one wall announces the menu of tours offered by the Yakutat Charter Boat Company.

The captain sits at the wheel, steering the boat and occasionally checking the radar readout.

>n
You can't go that way.

>s
(first opening the cabin door)

Deck
The whole back half of the boat is open, allowing you to view the surroundings without intervening windows -- if you can stand the cold.

A very heavy ice chest sits on the ground.

All around the boat bob chunks of glacier ice.

>x chest
You see nothing special about the ice chest.

>open chest
You open the ice chest.

>x chest
The ice chest is empty.

>l
Deck
The whole back half of the boat is open, allowing you to view the surroundings without intervening windows -- if you can stand the cold.

A very heavy ice chest sits on the ground.

All around the boat bob chunks of glacier ice.

>x ice
Which do you mean, the ice chest or the glacier ice?

>x glacier ice
Curiously cooled into funny-shaped chunks.

>take glacier ice
You are having a hard time fishing out the ice with your bare hands.

>n
Cabin
The front of the small cabin is entirely occupied with navigational instruments, a radar display, and radios for calling back to shore. Along each side runs a bench with faded blue vinyl cushions, which can be lifted to reveal the storage space underneath. A glass case against the wall contains several fishing rods.

Scratched windows offer a view of the surrounding bay, and there is a door south to the deck. A sign taped to one wall announces the menu of tours offered by the Yakutat Charter Boat Company.

The captain sits at the wheel, steering the boat and occasionally checking the radar readout.

>take rod
The glass case isn't open.

>open case
(first unlocking the glass case)
You lack a key that fits the glass case.

>ask captain for key
"Sure, you can -- well, get me a drink first, would you?"

>s
Deck
The whole back half of the boat is open, allowing you to view the surroundings without intervening windows -- if you can stand the cold.

A very heavy ice chest sits on the ground.

All around the boat bob chunks of glacier ice.

>n
Cabin
The front of the small cabin is entirely occupied with navigational instruments, a radar display, and radios for calling back to shore. Along each side runs a bench with faded blue vinyl cushions, which can be lifted to reveal the storage space underneath. A glass case against the wall contains several fishing rods.

Scratched windows offer a view of the surrounding bay, and there is a door south to the deck. A sign taped to one wall announces the menu of tours offered by the Yakutat Charter Boat Company.

The captain sits at the wheel, steering the boat and occasionally checking the radar readout.

>s
Deck
The whole back half of the boat is open, allowing you to view the surroundings without intervening windows -- if you can stand the cold.

A very heavy ice chest sits on the ground.

All around the boat bob chunks of glacier ice.

>l
Deck
The whole back half of the boat is open, allowing you to view the surroundings without intervening windows -- if you can stand the cold.

A very heavy ice chest sits on the ground.

All around the boat bob chunks of glacier ice.

>take some glacier ice
You are having a hard time fishing out the ice with your bare hands.

>n
Cabin
The front of the small cabin is entirely occupied with navigational instruments, a radar display, and radios for calling back to shore. Along each side runs a bench with faded blue vinyl cushions, which can be lifted to reveal the storage space underneath. A glass case against the wall contains several fishing rods.

Scratched windows offer a view of the surrounding bay, and there is a door south to the deck. A sign taped to one wall announces the menu of tours offered by the Yakutat Charter Boat Company.

The captain sits at the wheel, steering the boat and occasionally checking the radar readout.

>open bench
You open the storage compartment, revealing some nets and a warm Coke.

>take net
Taken.

>s
Deck
The whole back half of the boat is open, allowing you to view the surroundings without intervening windows -- if you can stand the cold.

A very heavy ice chest sits on the ground.

All around the boat bob chunks of glacier ice.

>cast net
That's not a verb I recognise.

>take glacier ice with net
I only understood you as far as wanting to take the glacier ice.

>take glacier ice
You scoop up the ice with the net.

>put ice in ice
(the ice chest in the ice chest)
(first taking the ice chest)
It's too heavy to lift, but you might be able to push it, and just inch it over the frame of the door.

>put glacier ice in chest
(first taking the glacier ice)
You put the glacier ice into the ice chest.

>n
Cabin
The front of the small cabin is entirely occupied with navigational instruments, a radar display, and radios for calling back to shore. Along each side runs a bench with faded blue vinyl cushions, one of which is currently lifted to allow access to the storage compartment within. A glass case against the wall contains several fishing rods.

Scratched windows offer a view of the surrounding bay, and there is a door south to the deck. A sign taped to one wall announces the menu of tours offered by the Yakutat Charter Boat Company.

The captain sits at the wheel, steering the boat and occasionally checking the radar readout.

>x bench
You see nothing special about the bench.

>l bench
You see nothing special about the bench.

>take coke
Taken.

>s
Deck
The whole back half of the boat is open, allowing you to view the surroundings without intervening windows -- if you can stand the cold.

A very heavy ice chest sits on the ground.

>put coke in ice chest
You put the warm Coke into the ice chest.

>take coke
Taken.

>x coke
You see nothing special about the room temperature Coke.

>put coke in ice chest
You put the room temperature Coke into the ice chest.

>take coke
Taken.

>x coke
You see nothing special about the cool Coke.

>put coke in chest
You put the cool Coke into the ice chest.

>take coke
Taken.

>x coke
You see nothing special about the cold Coke.

>n
Cabin
The front of the small cabin is entirely occupied with navigational instruments, a radar display, and radios for calling back to shore. Along each side runs a bench with faded blue vinyl cushions, one of which is currently lifted to allow access to the storage compartment within. A glass case against the wall contains several fishing rods.

Scratched windows offer a view of the surrounding bay, and there is a door south to the deck. A sign taped to one wall announces the menu of tours offered by the Yakutat Charter Boat Company.

The captain sits at the wheel, steering the boat and occasionally checking the radar readout.

>ask captain for key
"Sure, you can -- well, get me a drink first, would you?"

>give captain coke
"Ah, thank you," he says. How he can drink an iced soda on a day like today is an open question, but Alaskans are special.

[Your score has just gone up by two points.]

>take key
That seems to belong to the Captain.

>ask captain for key
"Here, knock yourself out."

>open case with key
You unlock the glass case.

>x case
In the glass case is a collection of fishing rods.

>take rod
The glass case isn't open.

>open case
You open the glass case.

>take rod
(putting the nets into the backpack to make room)
Success is yours! (Now if only you knew anything about fishing.)

    *** The End ***

In that game you scored 5 out of a possible 5, in 56 turns.

Would you like to RESTART, RESTORE a saved game, QUIT or UNDO the last command?

* * *

>n
You can't go that way.

>s
You can't go that way.

>e
You can't go that way.

>w
You can't go that way.

>d
Library
Here, it seems, you have found your mark: books line both walls, a dark carpet lies on the floor, and a strange dress hangs up in a presentation case. And the thing you were told to look for, a desk with three drawers.

A spiral staircase leads up and out.

>w
You can't go that way.

>e
You can't go that way.

>s
You can't go that way.

>n
You can't go that way.

>d
You can't go that way.

>out
But you aren't in anything at the moment.

>x desk
A deep, satin-lustrous cherry, with scrollwork legs and gilt touches. The years have not been kind, and it has cracked and split in several places; the finish is damaged, and where there is inlaid mother of pearl, it is beginning to come up from its bed.  But it is still a sound piece, and features three drawers.

(Your employers were able to tell you to look for it, but not which drawer to look in. Typical.)

>open top drawer
There is a tremendous screech, but nothing whatsoever inside, not even dust.

>open middle drawer
You struggle to open this one a bit more quietly, conscious all the time of noise...  but no, it's empty.  Just stands to reason.

>open bottom drawer
You open the bottom drawer, revealing a mysterious thing.

>take thing
Taken.

>x thing
A very familiar-looking hemispherical weight of metal, goldish in tone though perhaps not made of gold.  This one has a slight stickiness about the bottom surface.

>u
Turret
A cramped little room distinguished chiefly by the spiral staircase that descends from it. The windows look out over the rooftop.

>u
You can't go that way.

>d
Library
Here, it seems, you have found your mark: books line both walls, a dark carpet lies on the floor, and a strange dress hangs up in a presentation case. And the thing you were told to look for, a desk with three drawers.

A spiral staircase leads up and out.

>x rug
It is too dark for you to make out details of the antique design, which seems dimly to represent an early voyage to the moon, with ships and the travelling stars.

>look under the desk
There's nothing down there, but this doesn't come as a great surprise.

>look under the carpet
No time for that kind of nonsense. You'd better get out and away while you can.

>up
Turret
A cramped little room distinguished chiefly by the spiral staircase that descends from it. The windows look out over the rooftop.

>d
Library
Here, it seems, you have found your mark: books line both walls, a dark carpet lies on the floor, and a strange dress hangs up in a presentation case. And the thing you were told to look for, a desk with three drawers.

A spiral staircase leads up and out.

>attack case
The glass pane of the presentation case shatters, throwing fine glass everywhere, including over the delicate museum-piece inside. Nor does the noise pass unnoted: only a second passes before there are footsteps in the hall, and though you make for the concealing darkness and escape of the turret, you are not swift enough. The servants are soon on you, and you are made to regret, quite painfully, this casual act of vandalism.

    *** You have lost your opportunity. ***

Would you like to RESTART, RESTORE a saved game, QUIT or UNDO the last command?

>quit
[ The game has finished ]

* * *

>l
Stuffy Office
The windows are closed, making the sultry air even more unbearable. A narrow slice of Caribbean blue is visible between the scuba gear rental shop and the recreated 17th century pirate tavern.

The office is cheerfully furnished with wicker chairs and white curtains, but the tropical decorating scheme stopped at the desk, which is heavy oak and absolutely covered with papers.

>g
Camp Bethel Kitchen
A tidy, efficient industrial kitchen, without any of the kitsch rusticity found elsewhere.

Jeremy stands at his station, chopping celery.

Fluffy is chasing its tail.

A large housefly lands on a countertop.

>g
Camp Bethel Kitchen
A tidy, efficient industrial kitchen, without any of the kitsch rusticity found elsewhere.

Jeremy stands at his station, peeling carrots.

Fluffy is staring out the window.

A large housefly circles Jeremy's chef hat.

>g
Camp Bethel Kitchen
A tidy, efficient industrial kitchen, without any of the kitsch rusticity found elsewhere.

Jeremy stands at his station, tying fresh herbs together with string.

Fluffy is rubbing itself against your leg.

A large housefly lands on a countertop.

>g
Camp Bethel Kitchen
A tidy, efficient industrial kitchen, without any of the kitsch rusticity found elsewhere.

Jeremy stands at his station, putting all the vegetables into a large stock pot.

Fluffy is chasing its tail.

A large housefly circles Jeremy's chef hat.

>g
Camp Bethel Kitchen
A tidy, efficient industrial kitchen, without any of the kitsch rusticity found elsewhere.

Jeremy stands at his station, watching over his boiling vegetable stock.

Fluffy is rubbing itself against your leg.

A large housefly lands on a countertop.

>g
Camp Bethel Kitchen
A tidy, efficient industrial kitchen, without any of the kitsch rusticity found elsewhere.

Jeremy stands at his station, peeling white onions.

Fluffy is staring out the window.

A large housefly flies around noisily.

>g
Camp Bethel Kitchen
A tidy, efficient industrial kitchen, without any of the kitsch rusticity found elsewhere.

Jeremy stands at his station, briskly dicing onions.

Fluffy is rubbing itself against your leg.

A large housefly circles Jeremy's chef hat.

>g
Camp Bethel Kitchen
A tidy, efficient industrial kitchen, without any of the kitsch rusticity found elsewhere.

Jeremy stands at his station, chopping celery.

Fluffy is chasing its tail.

A large housefly lands on a countertop.

>g
Camp Bethel Kitchen
A tidy, efficient industrial kitchen, without any of the kitsch rusticity found elsewhere.

Jeremy stands at his station, peeling carrots.

Fluffy is staring out the window.

A large housefly flies around noisily.

>g
Camp Bethel Kitchen
A tidy, efficient industrial kitchen, without any of the kitsch rusticity found elsewhere.

Jeremy stands at his station, tying fresh herbs together with string.

Fluffy is staring out the window.

A large housefly circles Jeremy's chef hat.

>g
Camp Bethel Kitchen
A tidy, efficient industrial kitchen, without any of the kitsch rusticity found elsewhere.

Jeremy stands at his station, putting all the vegetables into a large stock pot.

Fluffy is staring out the window.

A large housefly lands on a countertop.

>g
Camp Bethel Kitchen
A tidy, efficient industrial kitchen, without any of the kitsch rusticity found elsewhere.

Jeremy stands at his station, watching over his boiling vegetable stock.

Fluffy is staring out the window.

A large housefly flies around noisily.

>g
Camp Bethel Kitchen
A tidy, efficient industrial kitchen, without any of the kitsch rusticity found elsewhere.

Jeremy stands at his station, peeling white onions.

Fluffy is chasing its tail.

A large housefly lands on a countertop.

>g
Camp Bethel Kitchen
A tidy, efficient industrial kitchen, without any of the kitsch rusticity found elsewhere.

Jeremy stands at his station, briskly dicing onions.

Fluffy is staring out the window.

A large housefly flies around noisily.

>ask Jeremy about his feelings for me
"I'm afraid I don't know much about that," Jeremy replies.

>ask jeremy about his amnesia
"Hm, I haven't the faintest," Jeremy drawls throatily.

>tell Jeremy about my unborn child
Jeremy looks surprised. "That's very interesting!"

>tell Jeremy about my unborn child
Jeremy looks intrigued. "I wish I'd known that sooner!"

>tell Jeremy about my unborn child
Jeremy looks surprised. "That's very interesting!"

>tell Jeremy about my unborn child
Jeremy looks intrigued. "You don't say!"

>tell Jeremy about my unborn child
Jeremy looks nonplussed. "That's very interesting!"

* * *

>l
Stuffy Office
The windows are closed, making the sultry air even more unbearable. A narrow slice of Caribbean blue is visible between the scuba gear rental shop and the recreated 17th century pirate tavern.

The office is cheerfully furnished with wicker chairs and white curtains, but the tropical decorating scheme stopped at the desk, which is heavy oak and absolutely covered with papers.

>x readout
The screen is blank.

The security readout is currently switched off.

>turn on readout
You switch the security readout on.

>x readout
The screen reads: 

  inner airlock (Docking Bay/Zocalo): UNLOCKED
  outer airlock (Docking Bay/Space): LOCKED
  quarantine seal (Zocalo/Medlab): LOCKED

>lock inner airlock with security pass
You lock the inner airlock.

>x readout
The screen reads: 

  inner airlock (Docking Bay/Zocalo): LOCKED
  outer airlock (Docking Bay/Space): LOCKED
  quarantine seal (Zocalo/Medlab): LOCKED

* * *

>l
Stuffy Office
The windows are closed, making the sultry air even more unbearable. A narrow slice of Caribbean blue is visible between the scuba gear rental shop and the recreated 17th century pirate tavern.

The office is cheerfully furnished with wicker chairs and white curtains, but the tropical decorating scheme stopped at the desk, which is heavy oak and absolutely covered with papers.

>x a bientot
You can't see any such thing.

>x plaque
You can't see any such thing.

>n
slendingabk
You can see a framed photograph of Icelandic Prime Minister Halldr sgrmsson, a ruler measuring ngstrms, a Bokml-Ltzebuergesch Ltzebuergesch-Bokml dictionary and a ticket to Troms via stfold here.

>n
You can't go that way.

>s
Chteau Bibliothque Franais
From this Borgesian construction, doorways lead into anterooms in each of the four cardinal directions.

You can see a painting of cole normale superiure students singing a ira, a frankly lesser-known journal of Niccol Polo, Cos fan tutte on CD, an extract of Herodotus concerning Artactes, an exit sign reading  BIENTT and a wicker basket marked CHLO (in which is a ginger cat) here.

>e
Alphabet Soup
A bewildering place of glyphs, sigils and signs. The Library proper leads back west: steps lead upwards to an Observatory, or downwards into what seems to be a dangerous area. A gaming lounge lies to the south.

You can see a Greek Alphabet, a Cyrillic Alphabet, a Hebrew alphabet and an embossed plaque here.

>x plaque
It seems to be a sign in Braille:  (I),  (N),  (F),  (O),  (R),  (M).

>w
Chteau Bibliothque Franais
From this Borgesian construction, doorways lead into anterooms in each of the four cardinal directions.

You can see a painting of cole normale superiure students singing a ira, a frankly lesser-known journal of Niccol Polo, Cos fan tutte on CD, an extract of Herodotus concerning Artactes, an exit sign reading  BIENTT and a wicker basket marked CHLO (in which is a ginger cat) here.

>w
Deutsche Universitt Bcherei
You can see a paper by Karl Weierstra, a general feeling of rger, an old sterreich passport and a Bach Clavier-bung open at the fugue  4 here.

>e
Chteau Bibliothque Franais
From this Borgesian construction, doorways lead into anterooms in each of the four cardinal directions.

You can see a painting of cole normale superiure students singing a ira, a frankly lesser-known journal of Niccol Polo, Cos fan tutte on CD, an extract of Herodotus concerning Artactes, an exit sign reading  BIENTT and a wicker basket marked CHLO (in which is a ginger cat) here.

>s
Miscellany Maana
You can see a guide to sop for nave sthetes, Lnnrot's Kalevala, a creed according to the Bah's, FALARO magazine, an Estonian poem by Tnu Trubetsky, a Portuguese-Italian recipe for macarro, a stripy hanging CANDY PIATA bag, a Punctuation Turned Upside Down pamphlet, an Italian brewers' anti-violence poster declaring BTTE NON BTTE, a map of , a dusty book titled The Parnasum of Lus Vaz bearing CAMES on its spine,  - The Official Journal of the Society for Vowels bearing Circumflexes and  comic - the youth edition here.

>x board
You can't see any such thing.

>x position
You can't see any such thing.

>n
Chteau Bibliothque Franais
From this Borgesian construction, doorways lead into anterooms in each of the four cardinal directions.

You can see a painting of cole normale superiure students singing a ira, a frankly lesser-known journal of Niccol Polo, Cos fan tutte on CD, an extract of Herodotus concerning Artactes, an exit sign reading  BIENTT and a wicker basket marked CHLO (in which is a ginger cat) here.

>e
Alphabet Soup
A bewildering place of glyphs, sigils and signs. The Library proper leads back west: steps lead upwards to an Observatory, or downwards into what seems to be a dangerous area. A gaming lounge lies to the south.

You can see a Greek Alphabet, a Cyrillic Alphabet, a Hebrew alphabet and an embossed plaque here.

>ww
That's not a verb I recognise.

>w
Chteau Bibliothque Franais
From this Borgesian construction, doorways lead into anterooms in each of the four cardinal directions.

You can see a painting of cole normale superiure students singing a ira, a frankly lesser-known journal of Niccol Polo, Cos fan tutte on CD, an extract of Herodotus concerning Artactes, an exit sign reading  BIENTT and a wicker basket marked CHLO (in which is a ginger cat) here.

* * *

>w
Deutsche Universitt Bcherei
You can see a paper by Karl Weierstra, a general feeling of rger, an old sterreich passport and a Bach Clavier-bung open at the fugue  4 here.

>x position
You can't see any such thing.

>w
You can't go that way.

>w
You can't go that way.

>a
That's not a verb I recognise.

>e
Chteau Bibliothque Franais
From this Borgesian construction, doorways lead into anterooms in each of the four cardinal directions.

You can see a painting of cole normale superiure students singing a ira, a frankly lesser-known journal of Niccol Polo, Cos fan tutte on CD, an extract of Herodotus concerning Artactes, an exit sign reading  BIENTT and a wicker basket marked CHLO (in which is a ginger cat) here.

>e
Alphabet Soup
A bewildering place of glyphs, sigils and signs. The Library proper leads back west: steps lead upwards to an Observatory, or downwards into what seems to be a dangerous area. A gaming lounge lies to the south.

You can see a Greek Alphabet, a Cyrillic Alphabet, a Hebrew alphabet and an embossed plaque here.

>s
Gaming Lounge
Hanging on one wall is Georges de la Tour's masterpiece Le Tricheur (the card-sharp). Visible are 8, 9, A, A, 6 but not one of them has a .

You can also see a chess position and a book of puzzle canons here.

>x chess
Fritz Saemisch - Aron Nimzowitsch, Copenhagen 1923: the Immortal Zugzwang Game. Nimzowitsch (black), observing that white will very soon have to play a terrible move, has just advanced his h pawn for no reason other than to wait. So it is white to play...
......k. 
...q..p. 
p..bp..p 
...p.r.. 
.p.Pp... 
...bQ.PP 
PP.B.rB. 
.N..R.RK 
"White must, willy-nilly, eventually throw himself upon the sword", in Nimzowitsch's commentary. We will now try to display the same position using chess-piece symbols in a Unicode font.

* * *

>l
Stuffy Office
The windows are closed, making the sultry air even more unbearable. A narrow slice of Caribbean blue is visible between the scuba gear rental shop and the recreated 17th century pirate tavern.

The office is cheerfully furnished with wicker chairs and white curtains, but the tropical decorating scheme stopped at the desk, which is heavy oak and absolutely covered with papers.

>i
You are carrying nothing.

>x desk
You see nothing special about the heavy oak desk.

>x envelope
You can't see any such thing.

>search desk
You rifle through the piles of bills and notices; invitations to conventions; advertisements for high-end prescription drugs; pink carbon sheets bearing patients' names and medical identification numbers in spidery, elderly handwriting. Almost at the bottom of the heap, you find what you were looking for: a creamy envelope with the address typed.

>look
Stuffy Office
The windows are closed, making the sultry air even more unbearable. A narrow slice of Caribbean blue is visible between the scuba gear rental shop and the recreated 17th century pirate tavern.

The office is cheerfully furnished with wicker chairs and white curtains, but the tropical decorating scheme stopped at the desk, which is heavy oak and absolutely covered with papers.

On the heavy oak desk is a creamy envelope (in which is a letter).

>get envelope
Taken.

>x envelope
There is no return address on the outside of the envelope, just the address of the Doctor's office -- but the legs of the capital A are rubbed down in a characteristic way, and the top of every R is open. There's no question that it comes from the same typewriter as the blackmail note.

In the creamy envelope is a letter.

* * *

Text Foosball
An Interactive Fiction
Release 1 / Serial number 140831 / Inform 7 build 6L02 (I6/v6.33 lib 6/12N) SD

Lounge
The Lounge is appointed with everything necessary to rest and relaxation: a vending machine, a potted palm, a stack of Entertainment Weekly issues from 1993, and -- your pride and joy -- a foosball game.

On the foosball game is a small white ball (still).

Joey is hunkered over the foosball handles on his side of the table.

>e
Eastern End
You can see a church door here.

>l
Darkness
It is pitch dark, and you can't see a thing.

>w
Undertomb
From this dim cross-groined room, exits depart east, south, and northwest.

You can see a lantern (providing light) here.

>s
Darkness
It is pitch dark, and you can't see a thing.

>n
Undertomb
From this dim cross-groined room, exits depart east, south, and northwest.

You can see a lantern (providing light) here.

>n
You can't go that way.

>w
You can't go that way.

>nw
Darkness
It is pitch dark, and you can't see a thing.

>se
Undertomb
From this dim cross-groined room, exits depart east, south, and northwest.

You can see a lantern (providing light) here.

>get lantern
Taken.

>nw
Dead End
This is a dead end, where crags in the uneven rock are caught by the blazing flame you hold aloft. Despite a gurgle of running water there is no sign of the stream.

>se
Undertomb
From this dim cross-groined room, exits depart east, south, and northwest.

>s
Collapsed Dead End
This is a dead end, where crags in the uneven rock are caught by the blazing flame you hold aloft. Despite a faint whispering of running water there is no sign of the stream.

>n
Undertomb
From this dim cross-groined room, exits depart east, south, and northwest.

>e
Dead End
This is a dead end, where crags in the uneven rock are caught by the blazing flame you hold aloft. Despite a faint whispering of running water there is no sign of the stream.

>w
Undertomb
From this dim cross-groined room, exits depart east, south, and northwest.

>east
Dead End
This is a dead end, where crags in the uneven rock are caught by the blazing flame you hold aloft. Despite a faint whispering of running water there is no sign of the stream.

>west
Undertomb
From this dim cross-groined room, exits depart east, south, and northwest.

>nw
Dead End
This is a dead end, where crags in the uneven rock are caught by the blazing flame you hold aloft. Despite a gurgle of running water there is no sign of the stream.

>l
Dead End
This is a dead end, where crags in the uneven rock are caught by the blazing flame you hold aloft. Despite a gurgle of running water there is no sign of the stream.

>read book
Many secrets are now yours.

>x lantern
The lantern shines with a flame at 1400C.

>z
You wait so long that your lantern dims a bit.

>x lantern
The lantern shines with a flame at 1100C.

>read book
Many secrets are now yours.

>look
Dead End
This is a dead end, where crags in the uneven rock are caught by the radiant flame you hold aloft. Despite a gurgle of running water there is no sign of the stream.

* * *

>e
Eastern End
You can see a church door here.

>e
(first opening the church door)

Courtyard
You can see a church door here.

>e
You can't go that way.

* * *

Text Foosball
An Interactive Fiction
Release 1 / Serial number 140831 / Inform 7 build 6L02 (I6/v6.33 lib 6/12N) SD

Lounge
The Lounge is appointed with everything necessary to rest and relaxation: a vending machine, a potted palm, a stack of Entertainment Weekly issues from 1993, and -- your pride and joy -- a foosball game.

On the foosball game is a small white ball (still).

Joey is hunkered over the foosball handles on his side of the table.

>x
(the signpost)
The signpost currently puts you on the road to London, but it swiftly alters again.

>x
(the signpost)
The signpost currently puts you on the road to Abingdon, but it swiftly alters again.

>turn signpost
With a hand's touch you turn the signpost to mark your way for Weston-super-Mare.

>n
You can't go that way.

>turn signpost
With a hand's touch you turn the signpost to mark your way for Runnymede.

>n
You can't go that way.

>turn signpost
With a hand's touch you turn the signpost to mark your way for Hell.

>turn signpost
With a hand's touch you turn the signpost to mark your way for Low Noon.

>turn signpost
With a hand's touch you turn the signpost to mark your way for London.

>turn signpost
With a hand's touch you turn the signpost to mark your way for Abingdon.

>turn signpost
With a hand's touch you turn the signpost to mark your way for Luton.

>turn sign
With a hand's touch you turn the signpost to mark your way for Weston-super-Mare.

>turn sign
With a hand's touch you turn the signpost to mark your way for Runnymede.

>turn sign
With a hand's touch you turn the signpost to mark your way for Hell.

>turn sign
With a hand's touch you turn the signpost to mark your way for Low Noon.

>n
A long road whose scenery does not change, nor anything on the horizon move but the sun. When at last you come to Noon, she hangs above your head like a hat.

    *** The End ***

Would you like to RESTART, RESTORE a saved game, QUIT or UNDO the last command?

>quit
[ The game has finished ]

* * *

Text Foosball
An Interactive Fiction
Release 1 / Serial number 140831 / Inform 7 build 6L02 (I6/v6.33 lib 6/12N) SD

Lounge
The Lounge is appointed with everything necessary to rest and relaxation: a vending machine, a potted palm, a stack of Entertainment Weekly issues from 1993, and -- your pride and joy -- a foosball game.

On the foosball game is a small white ball (still).

Joey is hunkered over the foosball handles on his side of the table.

>x table
Unusually short at 2 feet 3 inches.

On the low table is a gold nugget.

>x nugget
Distinct mostly in being made of metal.

* * *

Text Foosball
An Interactive Fiction
Release 1 / Serial number 140831 / Inform 7 build 6L02 (I6/v6.33 lib 6/12N) SD

Lounge
The Lounge is appointed with everything necessary to rest and relaxation: a vending machine, a potted palm, a stack of Entertainment Weekly issues from 1993, and -- your pride and joy -- a foosball game.

On the foosball game is a small white ball (still).

Joey is hunkered over the foosball handles on his side of the table.

>ask for help
You can't see any such thing.

>help
Sometimes the temptation to rely on hints becomes overwhelming, and you may prefer to turn off hints now. If you do so, your further requests for guidance will be unavailing. Turn off hints?

>no
Fine, since you're weak enough to ask: here is a complete walkthrough: GET EGG. PEEL EGG. SMELL EGG. DIVIDE YOLK INTO THREE PORTIONS. GIVE THE SMALLEST PORTION OF YOLK TO THE GOLDEN GOOSE. ASK THE GOOSE ABOUT WHETHER THE SWAN IS TO BE TRUSTED. GIVE THE LARGEST PORTION OF YOLK TO THE SWAN. DANCE CONGA. EAT MEDIUM PORTION. STAND ON HEAD. WEST.

>get egg
You can't see any such thing.

* * *

Text Foosball
An Interactive Fiction
Release 1 / Serial number 140831 / Inform 7 build 6L02 (I6/v6.33 lib 6/12N) SD

Lounge
The Lounge is appointed with everything necessary to rest and relaxation: a vending machine, a potted palm, a stack of Entertainment Weekly issues from 1993, and -- your pride and joy -- a foosball game.

On the foosball game is a small white ball (still).

Joey is hunkered over the foosball handles on his side of the table.

>g hoodie
You can hardly repeat that.

>g
You can hardly repeat that.

>get hoodie
Taken.

>x
What do you want to examine?

>x hoodie
Both elbows are stained from yesterday's entrenching project.

The hoodie's pocket contains a Swiss army knife and a folded map.

>take knife
Taken.

>take map
Taken.

>l
Tent
A dome made of two flexible rods and a lot of bright green ripstop nylon. It bills itself as a one-man tent, but you'd call it a two-dwarf tent: there is no way to arrange yourself on its square floor so that you can stretch out completely.

>i
You are carrying:
  a folded map
  a Swiss army knife
  a hoodie
  a whistle (being worn)

>put map in pocket
You put the folded map into the hoodie's pocket.

>put knife in pocket
You put the Swiss army knife into the hoodie's pocket.

>put whistle in pocket
(first taking it off)
There is no more room in the hoodie's pocket.

>wear hoodie
You put on the hoodie.

>destroy whistle
Violence isn't the answer to this one.

* * *

Text Foosball
An Interactive Fiction
Release 1 / Serial number 140831 / Inform 7 build 6L02 (I6/v6.33 lib 6/12N) SD

Lounge
The Lounge is appointed with everything necessary to rest and relaxation: a vending machine, a potted palm, a stack of Entertainment Weekly issues from 1993, and -- your pride and joy -- a foosball game.

On the foosball game is a small white ball (still).

Joey is hunkered over the foosball handles on his side of the table.

>g
You can hardly repeat that.

>l
Model Shop
You can see a model train and a toy elephant here.

>g
Model Shop
You can see a model train and a toy elephant here.

>g
Model Shop
You can see a model train and a toy elephant here.

>push button
Which do you mean, the model train's on/off button or the toy elephant's on/off button?

>push elephant
(the toy elephant)
Nothing obvious happens.

>push elephant's button
You switch the toy elephant on.

The toy elephant waves its trunk at you.

>push train's button
You switch the model train on.

The model train circles your feet, blowing small puffs of steam.

The toy elephant waves its trunk at you.

>l
Model Shop
You can see a model train and a toy elephant here.

The model train circles your feet, blowing small puffs of steam.

The toy elephant waves its trunk at you.

>push all buttons
You can't use multiple objects with that verb.

>push elephant's button
You switch the toy elephant off.

The model train circles your feet, blowing small puffs of steam.

>push train's button
You switch the model train off.

>g
You switch the model train on.

The model train circles your feet, blowing small puffs of steam.

>g
You switch the model train off.

>g
You switch the model train on.

The model train circles your feet, blowing small puffs of steam.

* * *

>g
You switch the model train off.

>q
Are you sure you want to quit?

>y
[ The game has finished ]

* * *

Text Foosball
An Interactive Fiction
Release 1 / Serial number 140831 / Inform 7 build 6L02 (I6/v6.33 lib 6/12N) SD

Lounge
The Lounge is appointed with everything necessary to rest and relaxation: a vending machine, a potted palm, a stack of Entertainment Weekly issues from 1993, and -- your pride and joy -- a foosball game.

On the foosball game is a small white ball (still).

Joey is hunkered over the foosball handles on his side of the table.

>test me
(Testing.)

>[1] x robot
The dangerous robot consists of a robotic head, a drill arm, a needle arm, a crushing leg and a kicking leg.

>[2] shoot robot
(with the Decomposition Ray Gun)
ZAP! The dangerous robot twinkles out of existence! The robotic head, the drill arm, the needle arm, the crushing leg and the kicking leg clatter to the ground! 

>[3] fire at kicking leg
(with the Decomposition Ray Gun)
ZAP! The kicking leg twinkles out of existence! 

>[4] shoot gun at drill arm
ZAP! The drill arm twinkles out of existence! 

>[5] look
Deathbot Assembly Line
Here is the heart of the whole operation, where your opponents are assembled fresh from scrap metal and bits of old car.

You can see a crushing leg, a needle arm and a robotic head here.

>q
Are you sure you want to quit?

* * *

Text Foosball
An Interactive Fiction
Release 1 / Serial number 140831 / Inform 7 build 6L02 (I6/v6.33 lib 6/12N) SD

Lounge
The Lounge is appointed with everything necessary to rest and relaxation: a vending machine, a potted palm, a stack of Entertainment Weekly issues from 1993, and -- your pride and joy -- a foosball game.

On the foosball game is a small white ball (still).

Joey is hunkered over the foosball handles on his side of the table.

>x chair
Quite ordinary, really, but for the heady rush of power that comes of sitting in it.

The command chair includes some casters.

>x computer
The computer is so large that you would be unable to operate it all from one position. Alas, it does not come with a manual.

The Universe Management Computer includes a chartreuse indicator light, an ennui meter, a golden knob settable to 15,000 positions, a toothpick dispenser and a button labeled RESTART.

>x ennui meter
You can't be bothered.

>exit
But you aren't in anything at the moment.

I beg your pardon?

>quit
Are you sure you want to quit?

>y
[ The game has finished ]

* * *

Text Foosball
An Interactive Fiction
Release 1 / Serial number 140831 / Inform 7 build 6L02 (I6/v6.33 lib 6/12N) SD

Lounge
The Lounge is appointed with everything necessary to rest and relaxation: a vending machine, a potted palm, a stack of Entertainment Weekly issues from 1993, and -- your pride and joy -- a foosball game.

On the foosball game is a small white ball (still).

Joey is hunkered over the foosball handles on his side of the table.

>w
Lawn
The grass underfoot is thick and green. The lawn extends to the south, the southwest and the west from here.

You can see a picnic table and a wicker basket here.

>s
Lawn
The grass underfoot is thick and green. The lawn extends to the north, the northwest and the west from here.

>w
Lawn
The grass underfoot is thick and green. The lawn extends to the north, the northeast and the east from here.

>n
Lawn
The grass underfoot is thick and green. The lawn extends to the south, the southeast and the east from here.

You can see a birdbath here.

* * *

Text Foosball
An Interactive Fiction
Release 1 / Serial number 140831 / Inform 7 build 6L02 (I6/v6.33 lib 6/12N) SD

Lounge
The Lounge is appointed with everything necessary to rest and relaxation: a vending machine, a potted palm, a stack of Entertainment Weekly issues from 1993, and -- your pride and joy -- a foosball game.

On the foosball game is a small white ball (still).

Joey is hunkered over the foosball handles on his side of the table.

>i
You are carrying:
  a cleated left shoe (being worn)
  a cleated right shoe (being worn)

The parquet floor mutters about the things people wear to walk on parquet floors these days.

Humming to herself, Alison brings in a drippy cold glass of ice water and sets it down smack on the red velvet dining chair, then goes back out.

You sense some resentment from the red velvet dining chair.

[Your score has just gone down by one point.]

>x
What do you want to examine?

>q
Are you sure you want to quit?

* * *

>i
You are carrying:
  a cleated left shoe (being worn)
  a cleated right shoe (being worn)

The parquet floor mutters about the things people wear to walk on parquet floors these days.

Humming to herself, Alison brings in a drippy cold glass of ice water and sets it down smack on the red velvet dining chair, then goes back out.

You sense some resentment from the red velvet dining chair.

[Your score has just gone down by one point.]

>take off cleated left shoe
You take off the cleated left shoe.

"Oh dear," murmurs the red chair, as the drippy cold glass of ice water drips into its velvety seat. "Oh dear, I will have a damp spot. This is so very -- what will people think?"

Whistling a jaunty tune, Alison brings in a hot platter and deposits it on the red velvet dining chair, then returns to the kitchen.

You sense some resentment from the red velvet dining chair.

>take off cleated right shoe
You take off the cleated right shoe.

"Oh dear," murmurs the red chair, as the drippy cold glass of ice water drips into its velvety seat. "Oh dear, I will have a damp spot. This is so very -- what will people think?"

Humming to herself, Alison brings in the cold ceramic tile and sets it down smack on the blue suede armchair, then goes back out.

You sense some resentment from the blue suede armchair and the red velvet dining chair.

>take the glass
You're carrying too many things already.

"Oh dear," murmurs the red chair, as the drippy cold glass of ice water drips into its velvety seat. "Oh dear, I will have a damp spot. This is so very -- what will people think?"

You sense some resentment from the blue suede armchair and the red velvet dining chair.

>i
You are carrying:
  a cleated left shoe
  a cleated right shoe

"Oh dear," murmurs the red chair, as the drippy cold glass of ice water drips into its velvety seat. "Oh dear, I will have a damp spot. This is so very -- what will people think?"

You sense some resentment from the blue suede armchair and the red velvet dining chair.

>set the shoes on the red chair
You can't see any such thing.

>set the cleated left shoe on the red chair
I didn't understand that sentence.

>drop the cleated left shoe on the red chair
There is no more room on the red velvet dining chair.

"Oh dear," murmurs the red chair, as the drippy cold glass of ice water drips into its velvety seat. "Oh dear, I will have a damp spot. This is so very -- what will people think?"

You sense some resentment from the blue suede armchair and the red velvet dining chair.

>drop the cleated left shoe
Dropped.

"Oh dear," murmurs the red chair, as the drippy cold glass of ice water drips into its velvety seat. "Oh dear, I will have a damp spot. This is so very -- what will people think?"

You sense some resentment from the blue suede armchair and the red velvet dining chair.

[Your score has just gone down by one point.]

>take the glass
With a sense of martyrdom, you retrieve the drippy cold glass of ice water, which dribbles water down your cuffs.

"The cleated left shoe should not be on a parquet floor," sings the parquet floor sadly.

You sense some resentment from the blue suede armchair and the red velvet dining chair.

>drop the glass on the blue chair
There is no more room on the blue suede armchair.

"The cleated left shoe should not be on a parquet floor," sings the parquet floor sadly.

You sense some resentment from the blue suede armchair and the red velvet dining chair.

>drop the cleated right shoe on the table
You put the cleated right shoe on the fussy table.

The table holds very very very still lest the cleated right shoe mar its finish. But its resentment is palpable.

You sense some resentment from the fussy table, the blue suede armchair and the red velvet dining chair.

[Your score has just gone down by one point.]

>x blue chair
Quiet, mellow, and with a lingering aroma of clove cigarettes, and possibly something less legal. It doesn't sit up straight, and doesn't let anyone else do so either.

On the blue suede armchair is a cold ceramic tile.

The table holds very very very still lest the cleated right shoe mar its finish. But its resentment is palpable.

You sense some resentment from the fussy table, the blue suede armchair and the red velvet dining chair.

>take the tile
Taken.

The table holds very very very still lest the cleated right shoe mar its finish. But its resentment is palpable.

You sense some resentment from the fussy table and the red velvet dining chair.

[Your score has just gone up by one point.]

>drop the glass on the blue chair
You put the drippy cold glass of ice water on the blue suede armchair.

The drippy cold glass of ice water visibly begins degrading the suede where it sits. The armchair is tactfully silent.

You sense some resentment from the fussy table, the blue suede armchair and the red velvet dining chair.

[Your score has just gone down by one point.]

>x
(the cold ceramic tile)
You see nothing special about the cold ceramic tile.

The drippy cold glass of ice water visibly begins degrading the suede where it sits. The armchair is tactfully silent.

You sense some resentment from the fussy table, the blue suede armchair and the red velvet dining chair.

>i
You are carrying:
  a cold ceramic tile

The drippy cold glass of ice water visibly begins degrading the suede where it sits. The armchair is tactfully silent.

You sense some resentment from the fussy table, the blue suede armchair and the red velvet dining chair.

>take the cleated shoe from the table
Taken.

The drippy cold glass of ice water visibly begins degrading the suede where it sits. The armchair is tactfully silent.

You sense some resentment from the blue suede armchair and the red velvet dining chair.

[Your score has just gone up by one point.]

>place the tile on the table
That's not a verb I recognise.

>drop the tile on the table
You put the cold ceramic tile on the fussy table.

The drippy cold glass of ice water visibly begins degrading the suede where it sits. The armchair is tactfully silent.

You sense some resentment from the blue suede armchair and the red velvet dining chair.

>take the glass
With a sense of martyrdom, you retrieve the drippy cold glass of ice water, which dribbles water down your cuffs.

The table shivers under the cold ceramic tile.

You sense some resentment from the red velvet dining chair.

[Your score has just gone up by one point.]

>x red chair
In temperament, in bearing, in everything it is the opposite of the blue suede chair. It is concerned for its duty all the time, has a rigidly straight back, and pokes diners in the spine when it suspects them of overdoing things.

On the red velvet dining chair is a scalding platter.

The table shivers under the cold ceramic tile.

You sense some resentment from the red velvet dining chair.

>take the platter
You're carrying too many things already.

The table shivers under the cold ceramic tile.

You sense some resentment from the red velvet dining chair.

>i
You are carrying:
  a drippy cold glass of ice water
  a cleated right shoe

The table shivers under the cold ceramic tile.

You sense some resentment from the red velvet dining chair.

>drop the shoe
(the cleated right shoe)
Dropped.

The table shivers under the cold ceramic tile.

You sense some resentment from the red velvet dining chair.

>take the platter
"Right," you say. "I'll just hold onto the scalding platter, shall I? Because that won't be in the least uncomfortable for me."

The table shivers under the cold ceramic tile.

Just then the kettle boils in the kitchen. Whistling chirpily, Alison brings it in and sets it down smack on the fussy table, then goes back out.

You sense some resentment from the fussy table.

>drop the platter on the blue chair
You put the scalding platter on the blue suede armchair.

The table shivers under the cold ceramic tile.

You sense some resentment from the fussy table and the blue suede armchair.

[Your score has just gone down by one point.]

>take the shoe on the table
You can't see any such thing.

>take the glass on the table
I only understood you as far as wanting to take the drippy cold glass of ice water.

>take the glass
You already have that.

The table shivers under the cold ceramic tile.

You sense some resentment from the fussy table and the blue suede armchair.

>take the tile
Taken.

"Hey!" protests the table, practically smoking at the scalding kettle. "Heard of a trivet?"

You sense some resentment from the fussy table and the blue suede armchair.

>x table
It's hypochondriac: the result of a sojourn in a superior antique shop, where it picked up the scent of almond oil, words like provenance, and a secretive shame about being resurfaced.

Chairs don't get along with it.

In its mellowest moods, after a really good dusting, it will mention, casually, a cabinet it once knew, which was twelve feet tall, came from the Winter Palace, and had an asking price of $350K.

On the fussy table is a scalding kettle.

"Hey!" protests the table, practically smoking at the scalding kettle. "Heard of a trivet?"

You sense some resentment from the fussy table and the blue suede armchair.

>restart
Are you sure you want to restart?

>y
Revenge of the Fussy Table
An Interactive Fiction
Release 1 / Serial number 140820 / Inform 7 build 6L02 (I6/v6.33 lib 6/12N) SD

Dining Room
A room of handsome proportions, with an octagonal dining table on a fine parquet floor. The original set of chairs has been taken away, leaving only a red velvet dining chair and a blue suede armchair.

* * *

Text Foosball
An Interactive Fiction
Release 1 / Serial number 140831 / Inform 7 build 6L02 (I6/v6.33 lib 6/12N) SD

Lounge
The Lounge is appointed with everything necessary to rest and relaxation: a vending machine, a potted palm, a stack of Entertainment Weekly issues from 1993, and -- your pride and joy -- a foosball game.

On the foosball game is a small white ball (still).

Joey is hunkered over the foosball handles on his side of the table.

>x readout
The screen is blank.

The security readout is currently switched off.

* * *

Text Foosball
An Interactive Fiction
Release 1 / Serial number 140831 / Inform 7 build 6L02 (I6/v6.33 lib 6/12N) SD

Lounge
The Lounge is appointed with everything necessary to rest and relaxation: a vending machine, a potted palm, a stack of Entertainment Weekly issues from 1993, and -- your pride and joy -- a foosball game.

On the foosball game is a small white ball (still).

Joey is hunkered over the foosball handles on his side of the table.

>actions
Actions listing on.

>look in the mirror
[searching the mirror]
You see yourself reflected back at you.
[searching the mirror - failed]

>actions
Actions listing on.

>actions off
Actions listing off.

* * *

Text Foosball
An Interactive Fiction
Release 1 / Serial number 140831 / Inform 7 build 6L02 (I6/v6.33 lib 6/12N) SD

Lounge
The Lounge is appointed with everything necessary to rest and relaxation: a vending machine, a potted palm, a stack of Entertainment Weekly issues from 1993, and -- your pride and joy -- a foosball game.

On the foosball game is a small white ball (still).

Joey is hunkered over the foosball handles on his side of the table.

>s
Conducting EVA level 1

>w
Detective Offices

>n
You can't go that way.

>a
That's not a verb I recognise.

>e
Hilly Place
The grassland gives way to a somewhat more hilly area, though there is still very little to guide you any particular way.

>n
Open Plain
A wide-open grassy expanse, from which you could really go any way at all.

>n
You can't go that way.

* * *

>w
Detective Offices

>e
High School

>q
Are you sure you want to quit?

* * *

Text Foosball
An Interactive Fiction
Release 1 / Serial number 140831 / Inform 7 build 6L02 (I6/v6.33 lib 6/12N) SD

Lounge
The Lounge is appointed with everything necessary to rest and relaxation: a vending machine, a potted palm, a stack of Entertainment Weekly issues from 1993, and -- your pride and joy -- a foosball game.

On the foosball game is a small white ball (still).

Joey is hunkered over the foosball handles on his side of the table.

>z
Time passes.

>z
Time passes.

>z
Time passes.

Artemis arrives from Athens.

>z
Time passes.

Artemis heads to Athens.

>z
Time passes.

* * *

>z
Time passes.

Artemis heads to Athens.

>z
Time passes.

Artemis arrives from Athens.

>z
Time passes.

Artemis heads to Mycenae.

>z
Time passes.

>z
Time passes.

Artemis arrives from Mycenae.

>z
Time passes.

Artemis heads to Athens.

* * *

>z
Time passes.

Artemis heads to Mycenae.

>q
Are you sure you want to quit?

* * *

Text Foosball
An Interactive Fiction
Release 1 / Serial number 140831 / Inform 7 build 6L02 (I6/v6.33 lib 6/12N) SD

Lounge
The Lounge is appointed with everything necessary to rest and relaxation: a vending machine, a potted palm, a stack of Entertainment Weekly issues from 1993, and -- your pride and joy -- a foosball game.

On the foosball game is a small white ball (still).

Joey is hunkered over the foosball handles on his side of the table.

>up
Upward Path
The staircase switches back on itself many times as it ascends towards the Crash Site.

A sarcophagus rests in the niche here, the lid firmly in place.

It looks like there's a safe, lit path straight up.

>drop candle
Dropped.

>down
Tomb of Angels
This ancient underground tomb is lightless but for a few shafts from the surface. Everywhere in the shadows are carved angels, their faces worn away by water and pollution, their wings little more than nubs.

It looks like there's a safe, lit path if you go up.

>up
Upward Path
The staircase switches back on itself many times as it ascends towards the Crash Site.

A sarcophagus rests in the niche here, the lid firmly in place.

You can also see a candle (providing light) here.

It looks like there's a safe, lit path straight up.

>take the candle
Taken.

>open sarco
You can't see any such thing.

>open sarcophagus
You open the sarcophagus.

>put candle in sarcophagus
You put the candle into the sarcophagus.

>down
Tomb of Angels
This ancient underground tomb is lightless but for a few shafts from the surface. Everywhere in the shadows are carved angels, their faces worn away by water and pollution, their wings little more than nubs.

It looks like there's a safe, lit path if you go up.

>up
Upward Path
The staircase switches back on itself many times as it ascends towards the Crash Site.

A sarcophagus rests in the niche here, the lid pushed aside.

It looks like there's a safe, lit path straight up.

>close sarcophagus
You close the sarcophagus.

>d
Tomb of Angels
This ancient underground tomb is lightless but for a few shafts from the surface. Everywhere in the shadows are carved angels, their faces worn away by water and pollution, their wings little more than nubs.

It looks like there is no fully lit path from here to the Crash Site.

* * *

Text Foosball
An Interactive Fiction
Release 1 / Serial number 140831 / Inform 7 build 6L02 (I6/v6.33 lib 6/12N) SD

Lounge
The Lounge is appointed with everything necessary to rest and relaxation: a vending machine, a potted palm, a stack of Entertainment Weekly issues from 1993, and -- your pride and joy -- a foosball game.

On the foosball game is a small white ball (still).

Joey is hunkered over the foosball handles on his side of the table.

>examine me
Oh, stop fussing. You look fine.

>actions
Actions listing on.

>examine me
[examining yourself]
Oh, stop fussing. You look fine.
[examining yourself - failed]

* * *

Text Foosball
An Interactive Fiction
Release 1 / Serial number 140831 / Inform 7 build 6L02 (I6/v6.33 lib 6/12N) SD

Lounge
The Lounge is appointed with everything necessary to rest and relaxation: a vending machine, a potted palm, a stack of Entertainment Weekly issues from 1993, and -- your pride and joy -- a foosball game.

On the foosball game is a small white ball (still).

Joey is hunkered over the foosball handles on his side of the table.

>push zorb up hill
I only understood you as far as wanting to push the Zorb up.

>push zorb up
Lucy whoops delightedly as she rides along in the Zorb.

Crest

>enter zorb
You get into the Zorb.

In the Zorb you can see Lucy.

The Zorb rolls you down the hill!

Steep Hill (in the Zorb)
You can see a flat rock here.

In the Zorb you can see Lucy.

>z
Time passes.

The Zorb rolls you down the hill!

Valley (in the Zorb)
In the Zorb you can see Lucy.

>z
Time passes.

>exit zorb
I only understood you as far as wanting to exit.

>exit
You get out of the Zorb.

Valley
The Zorb is here.

>push zorb up
Lucy whoops delightedly as she rides along in the Zorb.

Steep Hill
You can see a flat rock here.

>push zorb up
Lucy whoops delightedly as she rides along in the Zorb.

Crest

* * *

Text Foosball
An Interactive Fiction
Release 1 / Serial number 140831 / Inform 7 build 6L02 (I6/v6.33 lib 6/12N) SD

Lounge
The Lounge is appointed with everything necessary to rest and relaxation: a vending machine, a potted palm, a stack of Entertainment Weekly issues from 1993, and -- your pride and joy -- a foosball game.

On the foosball game is a small white ball (still).

Joey is hunkered over the foosball handles on his side of the table.

>x yam
Well, at least it's not a dish of yakitori.

Your eye is attracted by some kind of surreptitious movement from the yam.

>x yam
Well, at least it's not a dish of yakitori.

>x yakitori
Well, at least it's not a yam.

The yataghan tries to slip from your grasp.

>take yapok
I don't suppose the yapok would care for that.

The yataghan tries to slip from your grasp.

>i
You are carrying:
  a yukata (being worn)
  a yataghan

The yataghan tries to slip from your grasp.

>drop yataghan
Dropped.

>q
You're sure?

>y
You were getting close to a breakthrough, you know.

Are you sure you want to quit?

* * *

Text Foosball
An Interactive Fiction
Release 1 / Serial number 140831 / Inform 7 build 6L02 (I6/v6.33 lib 6/12N) SD

Lounge
The Lounge is appointed with everything necessary to rest and relaxation: a vending machine, a potted palm, a stack of Entertainment Weekly issues from 1993, and -- your pride and joy -- a foosball game.

On the foosball game is a small white ball (still).

Joey is hunkered over the foosball handles on his side of the table.

>x aquarium
A very roomy aquarium, large enough to hold quite a variety of colorful sealife -- if any yet survived.

The evil fish is floating belly up! ...oh, curse. He was toying with you. As soon as he sees you looking, he goes back to swimming around.

>x fish
Even if you had had no prior experience with him, you would be able to see at a glance that this is an evil fish. From his sharkish nose to his razor fins, every inch of his compact body exudes hatred and danger.

The fish glares at you, as though to underline this point.

The evil fish is floating belly up! ...oh, curse. He was toying with you. As soon as he sees you looking, he goes back to swimming around.

>help
That's not a verb I recognise.

>feed the fish
You need the fish food first.

"Hey, nice SKIN TONE," shouts the evil fish. His words reach you in a spitting gurgle of aquarium water. "You gone over to a pure eggplant diet these days?"

>l
Studio
Decorated with Britney's signature flair. It was her innate sense of style that first made you forgive her that ludicrous name. And here it is displayed to the fullest: deep-hued drapes on the walls, the windows flung open with their stunning view of old Vienna, the faint smell of coffee that clings to everything. Her easel stands over by the windows, where the light is brightest.

A huge cabinet, in the guise of an armoire, stands between the windows.

On the easel is a painting.

On the table is a vase (empty).

In one corner of the room, a large aquarium bubbles in menacing fashion.

The evil fish darts to the bottom of the tank and moves the gravel around with his nose.

>x armoire
Large, and with a bit of an Art Nouveau theme going on in the shape of the doors.

The evil fish is swimming around the tank in lazy circles.

>i
You are carrying:
  a telegram
  a bouquet
  a lingerie bag
  a chef hat (being worn)

The evil fish darts to the bottom of the tank and moves the gravel around with his nose.

>n
You can't leave until you've fed the fish. Otherwise, he'll complain, and you will never hear the end of it.

"Hey, nice SKIN TONE," shouts the evil fish. His words reach you in a spitting gurgle of aquarium water. "You gone over to a pure eggplant diet these days?"

>s
You can't leave until you've fed the fish. Otherwise, he'll complain, and you will never hear the end of it.

The evil fish begins to butt his pointy nose against the glass walls of the tank.

>l
Studio
Decorated with Britney's signature flair. It was her innate sense of style that first made you forgive her that ludicrous name. And here it is displayed to the fullest: deep-hued drapes on the walls, the windows flung open with their stunning view of old Vienna, the faint smell of coffee that clings to everything. Her easel stands over by the windows, where the light is brightest.

A huge cabinet, in the guise of an armoire, stands between the windows.

On the easel is a painting.

On the table is a vase (empty).

In one corner of the room, a large aquarium bubbles in menacing fashion.

The evil fish darts to the bottom of the tank and moves the gravel around with his nose.

>g
Studio
Decorated with Britney's signature flair. It was her innate sense of style that first made you forgive her that ludicrous name. And here it is displayed to the fullest: deep-hued drapes on the walls, the windows flung open with their stunning view of old Vienna, the faint smell of coffee that clings to everything. Her easel stands over by the windows, where the light is brightest.

A huge cabinet, in the guise of an armoire, stands between the windows.

On the easel is a painting.

On the table is a vase (empty).

In one corner of the room, a large aquarium bubbles in menacing fashion.

The evil fish is floating belly up! ...oh, curse. He was toying with you. As soon as he sees you looking, he goes back to swimming around.

>kiss fish
You're saving all your lovin for someone a lot cuddlier.

"Hey, nice SKIN TONE," shouts the evil fish. His words reach you in a spitting gurgle of aquarium water. "You gone over to a pure eggplant diet these days?"

>x aquarium
A very roomy aquarium, large enough to hold quite a variety of colorful sealife -- if any yet survived.

The evil fish is swimming around the tank in lazy circles.

>l
Studio
Decorated with Britney's signature flair. It was her innate sense of style that first made you forgive her that ludicrous name. And here it is displayed to the fullest: deep-hued drapes on the walls, the windows flung open with their stunning view of old Vienna, the faint smell of coffee that clings to everything. Her easel stands over by the windows, where the light is brightest.

A huge cabinet, in the guise of an armoire, stands between the windows.

On the easel is a painting.

On the table is a vase (empty).

In one corner of the room, a large aquarium bubbles in menacing fashion.

"Hey, nice SKIN TONE," shouts the evil fish. His words reach you in a spitting gurgle of aquarium water. "You gone over to a pure eggplant diet these days?"

>x gravel
A lot of very small grey rocks.

The fish notices your gaze; makes a pathetic mime of trying to find little flakes of remaining food amongst the gravel.

The evil fish is floating belly up! ...oh, curse. He was toying with you. As soon as he sees you looking, he goes back to swimming around.

>x seaweed
Fake plastic seaweed of the kind generally bought in stores for exactly this purpose.

"Nice, hunh?" blubs the fish, taking a stabbing bite out of one just by way of demonstration. "Look so good I could eat it."

The evil fish is swimming around the tank in lazy circles.

>i
You are carrying:
  a telegram
  a bouquet
  a lingerie bag
  a chef hat (being worn)

The evil fish begins to butt his pointy nose against the glass walls of the tank.

>x telegram
A telegram, apparently. And dated three days ago. TRIUMPH OURS STOP BACK SOON STOP BE SURE TO FEED FISH STOP

"So," blubs the evil fish. "How about it? Little food over here?"

The evil fish is floating belly up! ...oh, curse. He was toying with you. As soon as he sees you looking, he goes back to swimming around.

>x bougquet
You can't see any such thing.

>x bouquet
Okay, so it's silly and sentimental and no doubt a waste of money, of which there is never really enough, but: you miss her. You've missed her since ten seconds after she stepped aboard the shuttle to Luna Prime, and when you saw these -- her favorites, pure golden tulips like springtime -- you had to have them.

"Oh, you shouldn't have," says the fish. "For me??" You just respond with a livid glare.

The evil fish darts to the bottom of the tank and moves the gravel around with his nose.

>smell bouquet
"Mmm-mm," says the fish. "Damn, I sure wish I had olfactory abilities. Hey, if I did, I might be even better at noticing the presence or absence of FOOD."

"Hey, nice SKIN TONE," shouts the evil fish. His words reach you in a spitting gurgle of aquarium water. "You gone over to a pure eggplant diet these days?"

>x lingerie
You grant yourself the satisfaction of a little peek inside. You went with a pale, silky ivory this time -- it has that kind of sophisticated innocence, and it goes well with the purple of your skin. A small smirk of anticipation crosses your lips.

"What's in THERE?" asks the fish. "Didja bring me take-out? I don't mind Chinese. They eat a lot of carp, but what do I care? I'm not a carp. Live and let live is what I s--"

"It's NOT take-out." You stare the fish down and for once he actually backstrokes a stroke or two. "It's PRIVATE."

The evil fish is swimming around the tank in lazy circles.

>g
You grant yourself the satisfaction of a little peek inside. You went with a pale, silky ivory this time -- it has that kind of sophisticated innocence, and it goes well with the purple of your skin. A small smirk of anticipation crosses your lips.

"If it's not take-out, I don't see the relevance!" shouts the fish. "Food is what you want in this situation. Food for MEEEE."

The evil fish darts to the bottom of the tank and moves the gravel around with his nose.

>x hat
A big white chef hat of the kind worn by chefs. In this case, you. Just goes to show what a hurry you were in on the way out of the restaurant.

"Hey, nice SKIN TONE," shouts the evil fish. His words reach you in a spitting gurgle of aquarium water. "You gone over to a pure eggplant diet these days?"

>k
That's not a verb I recognise.

>l
Studio
Decorated with Britney's signature flair. It was her innate sense of style that first made you forgive her that ludicrous name. And here it is displayed to the fullest: deep-hued drapes on the walls, the windows flung open with their stunning view of old Vienna, the faint smell of coffee that clings to everything. Her easel stands over by the windows, where the light is brightest.

A huge cabinet, in the guise of an armoire, stands between the windows.

On the easel is a painting.

On the table is a vase (empty).

In one corner of the room, a large aquarium bubbles in menacing fashion.

The evil fish darts to the bottom of the tank and moves the gravel around with his nose.

>open window
"Thank god some air," says the fish. "Man, it was getting hard to breathe in here." Two beats pass. "Oh wait."

The evil fish begins to butt his pointy nose against the glass walls of the tank.

>x painting
A ferocious banging from the aquarium attracts your attention as you go to look at the painting. "Hey!" screams the fish. "She doesn't like strangers looking at her paintings before they're DOONNNE!"

"Shut up, you," you reply casually. "I'm not a stranger." But the fish puts you off a little bit, and your heart is already in your mouth before you see the painting itself...

Only partway finished, but you can tell what it is: Britney's mother. You only met the old woman once, before she faded out of existence in a little hospice in Salzburg.

In the picture, her hands are grasping tightly at a small grey bottle, the pills to which she became addicted in her old age, and strange, gargoyle-like forms clutch at her arms and whisper in her ears.

But the disturbing thing, the truly awful thing, is the small figure of Britney herself, down in the corner, unmistakable: she is walking away. Her back turned.

You thought she'd finally talked this out, but evidently not. Still feels guilty for leaving. You only barely stop yourself from tracing, with your finger, those tiny slumped shoulders...

"So what's it of?" asks the fish, as you turn away. "She never asks if I want to see them, you know?"

"Her mother," you respond without thinking.

"Yeah? Man. I never knew my mother. Eggs, that's the way to go."

The evil fish is floating belly up! ...oh, curse. He was toying with you. As soon as he sees you looking, he goes back to swimming around.

>quit
Are you sure you want to quit?

* * *

Text Foosball
An Interactive Fiction
Release 1 / Serial number 140831 / Inform 7 build 6L02 (I6/v6.33 lib 6/12N) SD

Lounge
The Lounge is appointed with everything necessary to rest and relaxation: a vending machine, a potted palm, a stack of Entertainment Weekly issues from 1993, and -- your pride and joy -- a foosball game.

On the foosball game is a small white ball (still).

Joey is hunkered over the foosball handles on his side of the table.

>tes me
That's not a verb I recognise.

>test me
(Testing.)

>[1] look
Hollow Core
Truly a magnificent sight: the land curves up away from you in every direction, covered with the cities and fields of the Core People. Molten rock runs in the canals, bringing heat and light to every home.

At the center of the Earth hangs a dense black sun.

* * *

Text Foosball
An Interactive Fiction
Release 1 / Serial number 140831 / Inform 7 build 6L02 (I6/v6.33 lib 6/12N) SD

Lounge
The Lounge is appointed with everything necessary to rest and relaxation: a vending machine, a potted palm, a stack of Entertainment Weekly issues from 1993, and -- your pride and joy -- a foosball game.

On the foosball game is a small white ball (still).

Joey is hunkered over the foosball handles on his side of the table.

>set the time to 10
You can't see any such thing.

>set the game clock to 10
You set the game clock to 10:00 am.

>check the time
You can't see any such thing.

* * *

Text Foosball
An Interactive Fiction
Release 1 / Serial number 140831 / Inform 7 build 6L02 (I6/v6.33 lib 6/12N) SD

Lounge
The Lounge is appointed with everything necessary to rest and relaxation: a vending machine, a potted palm, a stack of Entertainment Weekly issues from 1993, and -- your pride and joy -- a foosball game.

On the foosball game is a small white ball (still).

Joey is hunkered over the foosball handles on his side of the table.

>check the time
You can't see any such thing.

>set the game clock to 10
You set the game clock to 10:00 am.

>check the time
10:00 am.

You should really install the Honeywell window fan.

>check the player's time
You can't see any such thing.

* * *

>check the time
You can't see any such thing.

>check the game clock
It shows the time to be 9:01 am.

The game clock is currently switched on.

You should really install the Honeywell window fan.

>set the game clock to midnight
You set the game clock to 12:00 am.

>check the game clock
It shows the time to be 12:00 am.

The game clock is currently switched on.

You should really install the Honeywell window fan.

* * *

Text Foosball
An Interactive Fiction
Release 1 / Serial number 140831 / Inform 7 build 6L02 (I6/v6.33 lib 6/12N) SD

Lounge
The Lounge is appointed with everything necessary to rest and relaxation: a vending machine, a potted palm, a stack of Entertainment Weekly issues from 1993, and -- your pride and joy -- a foosball game.

On the foosball game is a small white ball (still).

Joey is hunkered over the foosball handles on his side of the table.

>check it
The light switch is currently switched on.

You should really install the Honeywell window fan.

>check it
The light switch is currently switched on.

You should really install the Honeywell window fan.

* * *

Text Foosball
An Interactive Fiction
Release 1 / Serial number 140831 / Inform 7 build 6L02 (I6/v6.33 lib 6/12N) SD

Lounge
The Lounge is appointed with everything necessary to rest and relaxation: a vending machine, a potted palm, a stack of Entertainment Weekly issues from 1993, and -- your pride and joy -- a foosball game.

On the foosball game is a small white ball (still).

Joey is hunkered over the foosball handles on his side of the table.

>The lower downstairs stairs and the foyer are in the townhome.
That's not a verb I recognise.

* * *

Text Foosball
An Interactive Fiction
Release 1 / Serial number 140831 / Inform 7 build 6L02 (I6/v6.33 lib 6/12N) SD

Lounge
The Lounge is appointed with everything necessary to rest and relaxation: a vending machine, a potted palm, a stack of Entertainment Weekly issues from 1993, and -- your pride and joy -- a foosball game.

On the foosball game is a small white ball (still).

Joey is hunkered over the foosball handles on his side of the table.

>play joey
That's not a verb I recognise.

>take ball
You'd forfeit the game if you did that.

>help
That's not a verb I recognise.

>attack table
Violence isn't the answer to this one.

Joey fails to hit the ball in your direction. It remains still.

>x foosball game
On the foosball game is a small white ball (still).

Joey hits the ball solidly down towards your goal. Now it is approaching.

>turn tiny men
Thwack! You keep the ball from reaching its goal! Now it is receding.

Joey tries to block, but misses! Back it goes in the center, where it is still.

[Your score has just gone up by one point.]

>turn tiny men
You madly rotate the tiny men on sticks! Hoorah! You hit the ball!

Joey connects with your shot. Now the ball is approaching!

>turn tiny men
The ball rolls neatly into your goal, despite your efforts. After allowing a moment or two for Joey's gloating to pass, you replace it at the center.

Joey hits the ball solidly down towards your goal. Now it is approaching.

>turn tiny men
The ball rolls neatly into your goal, despite your efforts. After allowing a moment or two for Joey's gloating to pass, you replace it at the center.

Joey hits the ball solidly down towards your goal. Now it is approaching.

>turn tiny men
Thwack! You keep the ball from reaching its goal! Now it is receding.

Joey tries to block, but misses! Back it goes in the center, where it is still.

[Your score has just gone up by one point.]

>turn tiny men
You madly rotate the tiny men on sticks! Hoorah! You hit the ball!

Joey connects with your shot. Now the ball is still!

>turn tiny men
You madly rotate the tiny men on sticks! Somehow you fail to bring your monopodal player into contact with the ball.

Joey fails to hit the ball in your direction. It remains still.

>turn tiny men
You madly rotate the tiny men on sticks! Hoorah! You hit the ball!

Joey tries to block, but misses! Back it goes in the center, where it is still.

[Your score has just gone up by one point.]

>turn tiny men
You madly rotate the tiny men on sticks! Somehow you fail to bring your monopodal player into contact with the ball.

Joey hits the ball solidly down towards your goal. Now it is approaching.

>turn
(Joey)
Joey might not like that.

The ball rolls neatly into your goal, despite your efforts. After allowing a moment or two for Joey's gloating to pass, you replace it at the center.

>turn
(Joey)
Joey might not like that.

>turn tiny men
You madly rotate the tiny men on sticks! Somehow you fail to bring your monopodal player into contact with the ball.

Joey fails to hit the ball in your direction. It remains still.

>turn tiny men
You madly rotate the tiny men on sticks! Somehow you fail to bring your monopodal player into contact with the ball.

Joey fails to hit the ball in your direction. It remains still.

>turn men
You can't use multiple objects with that verb.

>turn tiny men
You madly rotate the tiny men on sticks! Hoorah! You hit the ball!

Joey connects with your shot. Now the ball is approaching!

>turn tiny men
The ball rolls neatly into your goal, despite your efforts. After allowing a moment or two for Joey's gloating to pass, you replace it at the center.

Joey fails to hit the ball in your direction. It remains still.

>take the ball
You'd forfeit the game if you did that.

Joey hits the ball solidly down towards your goal. Now it is approaching.

I beg your pardon?

>do nothing
That's not a verb I recognise.

>z
Time passes.

The ball rolls neatly into your goal, despite your efforts. After allowing a moment or two for Joey's gloating to pass, you replace it at the center.

>z
Time passes.

>z
Time passes.

Joey hits the ball solidly down towards your goal. Now it is approaching.

>z
Time passes.

The ball rolls neatly into your goal, despite your efforts. After allowing a moment or two for Joey's gloating to pass, you replace it at the center.

>z
Time passes.

    *** Rats! Joey wins! ***

In that game you scored 3 out of a possible 0, in 27 turns.

Would you like to RESTART, RESTORE a saved game, QUIT or UNDO the last command?